11111111111111111111
10000000000000000001
11111011111111011111
1EV0101C0000C1CCCCC1
1VCC1010111101111101
100C10101PC101CCCCC1
100C101C00C101011111
100C1011111101CCCCC1
100C1C000000C1111101
100C1111111111000001
100CCCCCCCCCCCCCCCC1
11111111111111111111
