11111
1E0C1
10P01
1C0V1
11111
