11111
1E0C1
10PV1
1C001
11111
