11111
1EVC1
1VPV1
1CVC1
11111
