11111111111111111111111111
10000000000000000000000001
100P0100101111010010111101
100001CC101CCC01CC101CCC01
10000111101110011110111001
100001CC101CCC01CC101CCC01
10000100101111010010111101
1E000000000000000000000001
10100010111010010101011101
1011C110101011C101C101C001
1010101010101C110110011101
1010001010101C0101C101C001
1010001011101C010101011101
10000000000000000000000001
11111111111111111111111111
