111111111111111111
1P001C10000C1111C1
1C100000010C10C001
100C01000100001111
10101CC00111101C01
101C01111001001101
11111000010C100001
1E0000100000000001
111111111111111111
