11111111111111111111
1E000000001000100001
10011110100010000111
10100V1011111111C101
101C1010C0000001C101
1C1C1011111111011101
1V1C10000000000000P1
11111111111111111111
