111111111111111111111111111111
1EP000000000000000000000000001
100100010101010001010001000001
100110110111011011011011000001
100101010101010101010101010101
10CCCCCCCCCCCCCCCCCCCCCCCCCC01
100100000000000000000000000001
101010010010010010010010010001
101100101011010101011010101001
101010111010110111010110111001
101100101010010101010010101001
10CCCCCCCCCCCCCCCCCCCCCCCCCC01
100000000000000000000000000001
100000000000000000000000000001
111111111111111111111111111111
