11111111
1P0000E1
1C000001
100C00C1
10000001
100C00C1
1C000001
11111111
