111111111111
1P0100000001
1C010C010C01
100100010001
1C010C010C01
100100010001
1C010C010C01
100100010001
1C010C010C01
100000010E01
111111111111
