11111111111111111111
1E11000000000V1V00V1
10VPV00000111V1V0001
1C0V0V00000011100001
101C0000000V000000V1
11111111111111111111
