11111111111111111111
1E110000000000100001
100P000000111C100001
1C000000000011100001
101C0000000000000001
11111111111111111111
